1111111111
1000100001
1000110101
1000000101
1111001001
1000001001
1111101101
1000000101
1111100001
1000000101
1000000111
1000010001
1000010001
10000001$1
1111111111
